*as+
*******
*a *  *
*     *
*** ***
s     *
*******