%Aoa
%%%%%%%%%%%%%%%%%%%%%%%%%%%%%%%
% %   % A     %   %       %   %
% % % %%%%%%% %%% % %%%%% % % %
%   % %     % %   %     % % % %
%%%%% % % %%% % %%%%%%% % % %%%
%   %   %   % % %   %   % %   %
% % %%%%%%% % % % % % %%% %%% %
% %     % %       % % %   %   %
% %%%%% % %%%%%%%%% %%% %%% %%%
%     %   %             %   % %
% %%% %%% % %%%%%%% %%%%% %%% %
%   % % %   %   %   %     %   o
%%%%% % %%%%%%% % %%%%% %%% %%%
%     %   %   % % %     %   % %
% %%%%% % % % % % % %%%%% % % %
%       %   %   %         %   %
%%%%%%%%%%%%%%%%%%%%%%%%%%%%%%%